######################################################################
#....................................................................#
#....................................................................#
#....................................................................#
#....................................................................#
#....................................................................#
#....................................................................#
#....................................................................#
#.......................#............................................#
#.......................#............................................#
#.......................#............................................#
#.......................#............................................#
#.......................#............................................#
#.......................#............................................#
#.......................#............................................#
#.......................#............................................#
#.......................#............................................#
#.......................#####################........................#
#....................................................................#
#....................................................................#
#....................................................................#
#....................................................................#
#....................................................................#
#....................................................................#
#....................................................................#
#....................................................................#
#....................................................................#
#....................................................................#
#....................................................................#
#....................................................................#
#....................................................................#
#....................................................................#
#....................................................................#
#....................................................................#
######################################################################
